0000000000
0000000000
0111001110
0110000110
0000000000
0000000000
0000110000
0000110000
0000110000
0001111000
0000000000
0000000000
0110000110
0001111000
0000110000